x-x-------x-x-----xxxxx
x--x-----x--x---------x
x---x---x---x---------x
x----x-x----x---------x
xxxxx-x-----xxxxx-----x
------------------------
xxxxxxxxxxxxxxxxxxxxxxxxxxxxxxxxxxxxxxxxxxxxxxxxxxxxxx
x----------------------------------------------------x
x----------------------------------------------------x
x----------------------------------------------------x
x----------------------------------------------------x
x----------------------------------------------------x
x----------------------------------------------------x
x----------------------------------------------------x
x----------------------------------------------------x
x----------------------------------------------------x
x----------------------------------------------------x
x----------------------------------------------------x
x------------------------xx--xx----------------------x
x------------------------xggggx----------------------x
x-------------------------gggg-----------------------x
x-------------------------gggg-----------------------x
x------------------------xggggx----------------------x
x------------------------xx--xx----------------------x
x----------------------------------------------------x
x----------------------------------------------------x
x----------------------------------------------------x
x----------------------------------------------------x
x--------p-------------------------------------------x
x----------------------------------------------------x
x----------------------------------------------------x
x----------------------------------------------------x
x----------------------------------------------------x
xxxxxxxxxxxxxxxxxxxxxxxxxxxxxxxxxxxxxxxxxxxxxxxxxxxxxx