xxxxxxxxxxxxxxxxxxxxxxxx
x----------------------x
x----------------------x
x----------------------x
x----------------------x
x----------------------x
x----------------------x
x----------------------x
x----------------------xxxxxxxxxxxxxxxxxxxxxxxxx
x----------------------------------------------x
x----------------------------------------------x
x----------------------------------------------x
x----------------------xxxxxxxxxxxxxxxxxxxx----x
x----------------------x------------------x----x	
x----------------------x------------------x----x
x----------------------x------------------x----x
x----------------------x------------------x----xxxxxx
x----------------------x------------------x----------
x----------------------x------------------x----------
x----------------------x------------------x----------
x----------------------x------------------xxxxxxxxxxx
x----------------------x
xxxxxxxxxxxxxxxxxxxxxxxx
